111111111111111111111111111111111111111111111
1P10000000000001000C0000011111111111111111111
1010000000000010011111000000000000000000000X1
101111111111110001000010000000000000000000001
1000000000000000100000C1100000110000C00000001
111111001111111100000000010000001000000000001
1000010C100C000001111111011111100100000000001
100001001000000001000001000000010010000000001
100001001111111111011101000000001001111111111
100001000000000C00010101000000000100000000001
100001111111111111110101X00000000000000000001
100000000000000000000101111111111111111111111
100000000000000000000100000000C00000000000001
1000000000000000000001111111111111111111111E1
111111111111111111111111111111111111111111111