1111111111111111111111111111111111
1E000000000000000000000000000000C1
1000000000000000000000000000000001
1000000000000000000000000000000001
100000000000000CCC0000000000000001
100000000000000CXC0000000000000001
100000000000000CCC0000000000000001
1000000000000000000000000000000001
1000000000000000000000000000000001
1000000000000000000000000000000001
1P00000000000000000000000000000001
1111111111111111111111111111111111